0,1,1,1,1,1,1,1,1,1,1,1,1,1,2
3,9,13,13,13,13,13,13,13,13,13,13,13,11,5
3,5, , , , , , , , , , , ,5,3
3,5, , , , , , , , , , , ,5,3
3,5, , , , , , , , , , , ,5,3
3,5, , , , , , , , , , , ,5,3
3,5, , , , , , , , , , , ,5,3
6,8, , , , , , , , , , , ,5,3
6,8, , , , , , , , , , , ,5,3
6,8, , , , , , , , , , , ,5,3
6,8, , , , , , , , , , , ,5,3
6,8, , , , , , , , , , , ,5,3
6,7,1,1,1,1,1,1,1,1,1,1,1,10,3
12,13,13,13,13,13,13,13,13,13,13,13,13,13,14